###################################################
##                                               ##
##                                               ##
##                                               ##
##                                               ##
##                                               ##
##                       *                       ##
##                                               ##
#################                ##################
##                                               ##
##                                               ##
##                                               ##
##                                               ##
##                                               ##
##          0                                    ##
##                                               ##
##                                               ##
##                                               ##
##                                               ##
##                                               ##
##                                               ##
##                                               ##
##                                               ##
##                                               ##
##                                               ##
##                                               ##
##                                               ##
###################################################