#########################
#            *          #
#                       #
#                       #
#                       #
#                       #
#                       #
#                       #
#                       #
#                       #
#                       #
#                       #
#                       #
#                       #
#          0            #
#                       #
#                       #
#                       #
#                       #
#########################